mmmmmmmmmmmmmmmmmmmmm
m2***m****m********gm
m*mm*m*mm*m*mmm*mmm*m
m*m*****m*m***m*m***m
m*m*mmm*m*m*m*****m*m
m****g****0*mmm3mmm*m
m*m*mmm*m*m*m*****m*m
m*m*****m*m***m*m***m
m*mm*m*mm*m*mmm*mmm*m
m****m****m*********m
mmmm0mmmmmmmmmmm0mmmm
m*********m****m****m
m*mmm*mmm*m*mm*m*mm*m
m***m*m***m******m**m
m*m*m5m*m*m*mmmm*g*mm
m*m*****m*1*m****m**m
m*mmm*mmm*m***mm*mm*m
m*m*****m*m*m*******m
m*m*mmm*m*m*mmmm*mm*m
mg********m********4m
mmmmmmmmmmmmmmmmmmmmm