mmmmmmmmmmmmmmmmm
mg*************gm
m*mm*m*mmm*m*mm*m
m****m*****m****m
mm*mmmm*m*mmmm*mm
00***m**m**m***00
mm*m*m0mmm0m*m*mm
mm*m*m00200m*m*mm
m**m*00s=s00*m**m
m*mm*m0s3s0m*mm*m
m****m0s4s0m****m
m*m*mm0s5s0mm*m*m
m*m**m0sss0m**m*m
m*mm*m00b00m*mm*m
0******m0m******0
mmm*mmmm0mmmm*mmm
m*******1*******m
m*mm*m*mmm*m*mm*m
m*m**m**m**m**m*m
m*m*mmm*m*mmm*m*m
mg*************gm
mmmmmmmmmmmmmmmmm