mmmmmmmmmmmmmmmmmmm
m*****************m
m*m*mm*mmmmm*mm*m*m
m*mg***m***m***gm*m
m*mm*m*m*m*m*m*mm*m
m****m***m***m****m
mm*mmmmm0m0mmmmm*mm
mm***m0002000m***mm
000m*m0ss=ss0m*m000
mmmm*00s345s00*mmmm
000m*m0sssss0m*m000
mm***m000b000m***mm
mm*m*mmm0m0mmm*m*mm
mm*m*****m*****m*mm
mm*mmm*m*m*m*mmm*mm
m******m***m******m
m*mm*m*mmmmm*m*mm*m
m*mg*m***1***m*gm*m
m*m*mmmm*m*mmmm*m*m
m********m********m
mmmmmmmmmmmmmmmmmmm