mmmmm0mmmmmmm0mmmmm
m***m0m*****m0m***m
m*m*****mmm*****m*m
mg**mm*mmgmm*mm**gm
m*m*m***mmm***m*m*m
m*m***m**1**m***m*m
m***m*m*mmm*m*m***m
m*mmm*m*****m*mmm*m
m*****mmm*mmm*****m
mmmmm*********mmmmm
m*****mmm*mmm*****m
m*mmm*********mmm*m
m***m*m0mmm0m*m***m
m*m***m00m00m***m*m
m*m*m0mm0m0mm0m*m*m
m***m000020000m***m
m*m*mm0ss=ss0mm*m*m
m*m*mm0s345s0mm*m*m
mgm*mm0sssss0mm*mgm
m***m0000b0000m***m
mmmmm0mmmmmmm0mmmmm