mmmmmmmmmmmmmmmm
m**************m
m*mmmmm0mmmmmm*m
m*m0000000000m*m
m*m0sss==sss0m*m
m*m0s000000s00*m
m*00s0mmmm0s0m*m
m*m0s000000s0m*m
m*m0ssssssss0m*m
m*m0000000000m*m
m*mmmmmm0mmmmm*m
m***mm*********m
mmm****mmmm*mm*m
mm**m0mm****mm*m
mm*m0m0m*mm****m
m***m00m*mm*mm*m
m*m*0mm******m*m
mgm*mm**m*mm*mgm
m*m*mm*mm*mm*m*m
m**************m
mmmmmmmmmmmmmmmm